11111112
11121211
22211121
12212121
11101222
21112111